10 10 
201 205 205 205 209 205 205 205 205 187
186 032 032 032 179 032 032 032 032 186
186 032 032 032 179 032 032 032 032 186
186 032 032 080 179 032 032 032 032 186
186 032 032 032 193 032 032 032 032 186
186 032 032 032 032 032 032 032 032 186
186 032 032 032 194 032 032 032 032 186
186 032 032 032 179 032 032 032 032 186
186 032 032 032 179 032 032 032 032 186
200 205 205 205 207 205 205 205 205 188